[
"",
"",
"",
"",
"",
"",
"",
"",
"",
"",
"",
"",
"",
"",
"",
"",
"",
"",
"",
"GGGGGGGGGGGGGGGGG                            GGGGGGGGGGGGGGGGGGGGGGGGGGGGGG                               GGGGGGGGGGGGGGGGGGGGGGGGG",
"DDDDDDDDDDDDDDDDD                            DDDDDDDDDDDDDDDDDDDDDDDDDDDDDD                               DDDDDDDDDDDDDDDDDDDDDDDDD",
"DDDDDDDDDDDDDDDDD                            DDDDDDDDDDDDDDDDDDDDDDDDDDDDDD                               DDDDDDDDDDDDDDDDDDDDDDDDD",
"DDDDDDDDDDDDDDDDD                            DDDDDDDDDDDDDDDDDDDDDDDDDDDDDD                               DDDDDDDDDDDDDDDDDDDDDDDDD",
"DDDDDDDDDDDDDDDDD                            DDDDDDDDDDDDDDDDDDDDDDDDDDDDDD                               DDDDDDDDDDDDDDDDDDDDDDDDD",
"DDDDDDDDDDDDDDDDD                            DDDDDDDDDDDDDDDDDDDDDDDDDDDDDD                               DDDDDDDDDDDDDDDDDDDDDDDDD",
"DDDDDDDDDDDDDDDDD                            DDDDDDDDDDDDDDDDDDDDDDDDDDDDDD                               DDDDDDDDDDDDDDDDDDDDDDDDD",
"DDDDDDDDDDDDDDDDD                            DDDDDDDDDDDDDDDDDDDDDDDDDDDDDD                               DDDDDDDDDDDDDDDDDDDDDDDDD",
"DDDDDDDDDDDDDDDDD                                                                                         DDDDDDDDDDDDDDDDDDDDDDDDD",
"DDDDDDDDDDDDDDDDD                                                                                         DDDDDDDDDDDDDDDDDDDDDDDDD",
"DDDDDDDDDDDDDDDDD                                                                                         DDDDDDDDDDDDDDDDDDDDDDDDD",
"DDDDDDDDDDDDDDDDD                                                                                         DDDDDDDDDDDDDDDDDDDDDDDDD",
"DDDDDDDDDDDDDDDDD                                                                                         DDDDDDDDDDDDDDDDDDDDDDDDD",
"DDDDDDDDDDDDDDDDD                                                                                         DDDDDDDDDDDDDDDDDDDDDDDDD",
"DDDDDDDDDDDDDDDDD                                                                                         DDDDDDDDDDDDDDDDDDDDDDDDD",
"DDDDDDDDDDDDDDDDD                                                                                         DDDDDDDDDDDDDDDDDDDDDDDDD",
"DDDDDDDDDDDDDDDDD                                                                                         DDDDDDDDDDDDDDDDDDDDDDDDD",
"DDDDDDDDDDDDDDDDD                                                                                         DDDDDDDDDDDDDDDDDDDDDDDDD",
"DDDDDDDDDDDDDDDDD                                                                                         DDDDDDDDDDDDDDDDDDDDDDDDD",
"DDDDDDDDDDDDDDDDD                                                                                         DDDDDDDDDDDDDDDDDDDDDDDDD",
"DDDDDDDDDDDDDDDDD                                                                                         DDDDDDDDDDDDDDDDDDDDDDDDD",
"DDDDDDDDDDDDDDDDDGGGGGGGGGGGGGGGGGGGGGGGGGGGGGGGGGGGGGGGGGGGGGGGGGGGGGGGGGGGGGGGGGGGGGGGGGGGGGGGGGGGGGGGGGDDDDDDDDDDDDDDDDDDDDDDDDD",
"DDDDDDDDDDDDDDDDDDDDDDDDDDDDDDDDDDDDDDDDDDDDDDDDDDDDDDDDDDDDDDDDDDDDDDDDDDDDDDDDDDDDDDDDDDDDDDDDDDDDDDDDDDDDDDDDDDDDDDDDDDDDDDDDDDD",
"DDDDDDDDDDDDDDDDDDDDDDDDDDDDDDDDDDDDDDDDDDDDDDDDDDDDDDDDDDDDDDDDDDDDDDDDDDDDDDDDDDDDDDDDDDDDDDDDDDDDDDDDDDDDDDDDDDDDDDDDDDDDDDDDDDD",
"DDDDDDDDDDDDDDDDDDDDDDDDDDDDDDDDDDDDDDDDDDDDDDDDDDDDDDDDDDDDDDDDDDDDDDDDDDDDDDDDDDDDDDDDDDDDDDDDDDDDDDDDDDDDDDDDDDDDDDDDDDDDDDDDDDD",
"DDDDDDDDDDDDDDDDDDDDDDDDDDDDDDDDDDDDDDDDDDDDDDDDDDDDDDDDDDDDDDDDDDDDDDDDDDDDDDDDDDDDDDDDDDDDDDDDDDDDDDDDDDDDDDDDDDDDDDDDDDDDDDDDDDD",
"DDDDDDDDDDDDDDDDDDDDDDDDDDDDDDDDDDDDDDDDDDDDDDDDDDDDDDDDDDDDDDDDDDDDDDDDDDDDDDDDDDDDDDDDDDDDDDDDDDDDDDDDDDDDDDDDDDDDDDDDDDDDDDDDDDD",
"DDDDDDDDDDDDDDDDDDDDDDDDDDDDDDDDDDDDDDDDDDDDDDDDDDDDDDDDDDDDDDDDDDDDDDDDDDDDDDDDDDDDDDDDDDDDDDDDDDDDDDDDDDDDDDDDDDDDDDDDDDDDDDDDDDD",
]