[
"",
"",
"",
"",
"GGG                              GGG",
"DDD                              DDD",
"DDD      GGGGGGGGGGGGGGGGGGG     DDD",
"DDD      DDDDDDDDDDDDDDDDDDD     DDD",
"DDD      DDDDDDDDDDDDDDDDDDD     DDD",
"DDD                              DDD",
"DDD                              DDD",
"DDD                              DDD",
"DDD                              DDD",
"DDDGGGGGGGGGGGGGGGGGGGGGGGGGGGGGGDDD",
"DDDDDDDDDDDDDDDDDDDDDDDDDDDDDDDDDDDD",
"DDDDDDDDDDDDDDDDDDDDDDDDDDDDDDDDDDDD",
"DDDDDDDDDDDDDDDDDDDDDDDDDDDDDDDDDDDD",
"DDDDDDDDDDDDDDDDDDDDDDDDDDDDDDDDDDDD",
"DDDDDDDDDDDDDDDDDDDDDDDDDDDDDDDDDDDD",
"DDDDDDDDDDDDDDDDDDDDDDDDDDDDDDDDDDDD",
"DDDDDDDDDDDDDDDDDDDDDDDDDDDDDDDDDDDD",

]