[
"",
"",
"",
"",
"",
"",
"",
"",
"",
"",
"",
"",
"",
"",
"",
"",
"",
"",
"",
"",
"",
"",
"",
"",
"",
"",
"",
"",
"",
"",
"",
"",
"",
"",
"",
"",
"",
"",
"",
"",
"",
"",
"",
"",
"DDDDDDDDDDDDDDDDD                            DDDDDDDDDDDDDDDDDDDDDDDDDDDDDD                               DDDDDDDDDDDDDDDDDDDDDDDDD",
"DDDDDDDDDDDDDDDDD                            DDDDDDDDDDDDDDDDDDDDDDDDDDDDDD                               DDDDDDDDDDDDDDDDDDDDDDDDD",
"DDDDDDDDDDDDDDDDD                            DDDDDDDDDDDDDDDDDDDDDDDDDDDDDD                               DDDDDDDDDDDDDDDDDDDDDDDDD",
"DDDDDDDDDDDDDDDDD                            DDDDDDDDDDDDDDDDDDDDDDDDDDDDDD                               DDDDDDDDDDDDDDDDDDDDDDDDD",
"DDDDDDDDDDDDDDDDD                            DDDDDDDDDDDDDDDDDDDDDDDDDDDDDD                               DDDDDDDDDDDDDDDDDDDDDDDDD",
"DDDDDDDDDDDDDDDDD                            DDDDDDDDDDDDDDDDDDDDDDDDDDDDDD                               DDDDDDDDDDDDDDDDDDDDDDDDD",
"DDDDDDDDDDDDDDDDD                            DDDDDDDDDDDDDDDDDDDDDDDDDDDDDD                               DDDDDDDDDDDDDDDDDDDDDDDDD",
"DDDDDDDDDDDDDDDDD                            DDDDDDDDDDDDDDDDDDDDDDDDDDDDDD                               DDDDDDDDDDDDDDDDDDDDDDDDD",
"DDDDDDDDDDDDDDDDD                                                                                         DDDDDDDDDDDDDDDDDDDDDDDDD",
"DDDDDDDDDDDDDDDDD                                                                                         DDDDDDDDDDDDDDDDDDDDDDDDD",
"DDDDDDDDDDDDDDDDD                                                                                         DDDDDDDDDDDDDDDDDDDDDDDDD",
"DDDDDDDDDDDDDDDDD                                                                                         DDDDDDDDDDDDDDDDDDDDDDDDD",
"DDDDDDDDDDDDDDDDD                                                                                         DDDDDDDDDDDDDDDDDDDDDDDDD",
"DDDDDDDDDDDDDDDDD                                                                                         DDDDDDDDDDDDDDDDDDDDDDDDD",
"DDDDDDDDDDDDDDDDD                                                                                         DDDDDDDDDDDDDDDDDDDDDDDDD",
"DDDDDDDDDDDDDDDDD                                                                                         DDDDDDDDDDDDDDDDDDDDDDDDD",
"DDDDDDDDDDDDDDDDD                                                                                         DDDDDDDDDDDDDDDDDDDDDDDDD",
"DDDDDDDDDDDDDDDDD                                                                                         DDDDDDDDDDDDDDDDDDDDDDDDD",
"DDDDDDDDDDDDDDDDD                                                                                         DDDDDDDDDDDDDDDDDDDDDDDDD",
"DDDDDDDDDDDDDDDDD                                                                                         DDDDDDDDDDDDDDDDDDDDDDDDD",
"DDDDDDDDDDDDDDDDD                                                                                         DDDDDDDDDDDDDDDDDDDDDDDDD",
"DDDDDDDDDDDDDDDDDDDDDDDDDDDDDDDDDDDDDDDDDDDDDDDDDDDDDDDDDDDDDDDDDDDDDDDDDDDDDDDDDDDDDDDDDDDDDDDDDDDDDDDDDDDDDDDDDDDDDDDDDDDDDDDDDDD",
"DDDDDDDDDDDDDDDDDDDDDDDDDDDDDDDDDDDDDDDDDDDDDDDDDDDDDDDDDDDDDDDDDDDDDDDDDDDDDDDDDDDDDDDDDDDDDDDDDDDDDDDDDDDDDDDDDDDDDDDDDDDDDDDDDDD",
"DDDDDDDDDDDDDDDDDDDDDDDDDDDDDDDDDDDDDDDDDDDDDDDDDDDDDDDDDDDDDDDDDDDDDDDDDDDDDDDDDDDDDDDDDDDDDDDDDDDDDDDDDDDDDDDDDDDDDDDDDDDDDDDDDDD",
"DDDDDDDDDDDDDDDDDDDDDDDDDDDDDDDDDDDDDDDDDDDDDDDDDDDDDDDDDDDDDDDDDDDDDDDDDDDDDDDDDDDDDDDDDDDDDDDDDDDDDDDDDDDDDDDDDDDDDDDDDDDDDDDDDDD",
"DDDDDDDDDDDDDDDDDDDDDDDDDDDDDDDDDDDDDDDDDDDDDDDDDDDDDDDDDDDDDDDDDDDDDDDDDDDDDDDDDDDDDDDDDDDDDDDDDDDDDDDDDDDDDDDDDDDDDDDDDDDDDDDDDDD",
"DDDDDDDDDDDDDDDDDDDDDDDDDDDDDDDDDDDDDDDDDDDDDDDDDDDDDDDDDDDDDDDDDDDDDDDDDDDDDDDDDDDDDDDDDDDDDDDDDDDDDDDDDDDDDDDDDDDDDDDDDDDDDDDDDDD",
"DDDDDDDDDDDDDDDDDDDDDDDDDDDDDDDDDDDDDDDDDDDDDDDDDDDDDDDDDDDDDDDDDDDDDDDDDDDDDDDDDDDDDDDDDDDDDDDDDDDDDDDDDDDDDDDDDDDDDDDDDDDDDDDDDDD",
]